Wo, Wo, Wo, Wo, Wo, Wo, Ww, Wwr, Wwr, Wo, Wo, Wo, Wo, Wo, Wo, Mm, Mm^Xm, Mm^Xm, Mm^Xm, Mm^Xm, Mm, Gg
Wo, Wo, Wo, Wo, Gg, Gll^Fmf, Ch, Wwr, Ch, Ww, Ww, Wo, Wo, Wo, Mm, Mm^Xm, Gll^Fdf, Mm^Xm, Rb, Mm, Rb, Rb
Wo, Wo, Wo, Ww, Ds, Gll^Fmf, Gg^Efm, Rb, Rb, Mm, Mm, Wo, Wo, Wo, Mm, Mm, Gg, 1 Ce, 2 Ce, Rb, Mm^Xm, Rb
Wo, Wo, Rr^Vhc, Gg^Gvs, Mm, Gg^Esd, Gll^Fmf, Mm, Rb, Mm, Hh, Wo, Ww, Gll^Fmf, Gg^Gvs, Gll^Fmf, Rb, Rb, Rb, Mm^Xm, Mm^Xm, Mm
Wo, Wo, Mm, Gg^Gvs, Wo, Ch, Rb, Rb, Rb, Ch, Ww, Ww, Gll^Fdf, Gg^Gvs, Mm, Gll^Fdf, Rb, Gs^Vh, Mm, Mm, Mm, Mm
Wo, Wo, Ss, Ch, Rr^Vhc, Mm, Gg^Esd, Mm, Gs^Vh, Rb, Ww^Bw\, Gll^Fmf, Rb, Gs^Vh, Rb, Rb, Gg, Gll^Fmf, Gg^Es, Hh, Gll^Fdf, Gll^Fmf
Wo, Wo, Wo, 4 Kh, Ch, Ch, Rb, Gll^Fdf, Gll^Fmf, Ww, Gll^Fdf, Rb, Mm, Rb, Gll^Fmf, Gll^Fdf, Gll^Fmf, Mm, Gll^Fmf, Gg^Efm, Gs^Vh, Gll^Fmf
Wo, Wo, Wo, Ww, Ww, Ww^Ewl, Gll^Fmf, Rb, Mm, Ww, Wwr, Gs^Vh, Hh, Gll^Fdf, Gll^Fdf, Hh, Gll^Fdf, Gll^Fmf, Mm, Mm, Ww^Ewf, Rb
Wo, Wo, Wo, Wo, Wwr, Ww, Gll^Fdf, Rb, Rb, Mm, Ww, Gd, Mm, Gll^Fmf, Gd, Gll^Fmf, Gll^Fdf, Hh, Gll^Fdf, Gll^Fmf, Gll^Fmf, Rb
Wo, Wo, Wo, Ds, Mm, Gg^Efm, Hh, Gll^Fdf, Rb, Gs^Vh, Rb, Ww, Ww, Gll^Fmf, Ww, Ww, Ww, Gll^Fmf, Gd, Gll^Fdf, Hh, Mm
Wo, Wo, Mm, Ds, Ce, Ce, Ce, Gll^Fmf, Gll^Fdf, Rb, Gll^Fmf, Rb, Mm, Ww, Mm, Gs^Vh, Re^Esd, Ww, Gg^Efm, Mm, Mm, Mm
Wo, Wo, Wo, Mm, Sm, 3 Ke, Ce, Gll^Fdf, Gg^Gvs, Gg^Efm, Rb, Rb, Rb, Ww, Mm, Mm, Ww, Ww, Rb, Rb, Rb^Esd, Mm
Wo, Wo, Wo, Wo, Wo, Ss, Mm, Gs^Vh, Gg^Gvs, Rb, Ch, Mm, Wwr, Ww^Bw\, Rb, Gll^Fdf, Ww^Bw/, Rb, Mm, Ch, Mm, Rb
Wo, Wo, Wo, Wo, Ww, Mm, Ww, Mm, Ww, Rb, Rb^Esd, Ww, Mm^Xm, Hh, Gg^Gvs, Rb, Gs^Vh, Ww, Wwr, Wo, Mm, Mm
Wo, Wo, Gll^Fdf, Wo, Wwr, Ww, Gg, Ww, Rb, Ww^Bw/, Ww, Ww, Mm^Xm, Mm, Hh, Gg^Gvs, Gll^Fmf, Ww, Rb, Mm, Mm, Mm
Wo, Gg^Efm, Mm, Gll^Fmf, Mm, Mm, Mm, Gll^Fdf, Rb, Gll^Fmf, Gll^Fdf, Hh, Mm^Xm, Mm^Xm, Mm^Xm, Gll^Fmf, Gll^Fmf, Ww, Ww, Gll^Fmf, Gll^Fdf, Mm
Wo, Wo, Gg, Mm, Gg, Mm, Gg, Rb^Esd, Rb, Gll^Fmf, Gll^Fmf, Mm, Mm, Mm^Xm, Mm, Mm, Gg, Gg^Efm, Ww, Mm, Mm, Mm
