Wo, Wo, Wo, Wo, Wo, Wo, Ww, Wwr, Wwr, Wo, Wo, Wo, Wo, Wo, Wo, Mm, Mm^Xm, Mm^Xm, Mm^Xm, Mm^Xm, Mm, Gg
Wo, Wo, Wo, Wo, Gg, Gll^Fmf, Ch, Wwr, Ch, Ww, Ww, Wo, Wo, Wo, Mm, Mm^Xm, Gll^Fdf, Mm^Xm, Rb, Mm, Rb, Rb
Wo, Wo, Wo, Ww, Ds, Gll^Fmf, Gg^Efm, Rb, Rb, Mm, Mm, Wo, Wo, Wo, Mm, Mm, Gg, 1 Ce, 2 Ce, Rb, Mm^Xm, Rb
Wo, Wo, Rr^Vhc, Gg^Gvs, Mm, Gg^Esd, Gll^Fmf, Mm, Rb, Mm, Hh, Wo, Ww, Gll^Fmf, Gg^Gvs, Gll^Fmf, Rb, Rb, Rb, Mm^Xm, Mm^Xm, Mm
Wo, Wo, Mm, Gg^Gvs, Wo, Ch, Rb, Rb, Rb, Ch, Ww, Ww, Gll^Fdf, Gg^Gvs, Mm, Gll^Fdf, Rb, Gs^Vh, Mm, Mm, Mm, Mm
Wo, Wo, Ss, Ch, Rr^Vhc, Mm, Gg^Esd, Mm, Gs^Vh, Rb, Ww^Bw\, Gll^Fmf, Rb, Gs^Vh, Rb, Rb, Gg, Gll^Fmf, Gg^Es, Hh, Gll^Fdf, Gll^Fmf
Wo, Wo, Wo, 4 Kh, Ch, Ch, Rb, Gll^Fdf, Gll^Fmf, Ww, Gll^Fdf, Rb, Mm, Rb, Gll^Fmf, Gll^Fdf, Gll^Fmf, Mm, Gll^Fmf, Gg^Efm, Gs^Vh, Gll^Fmf
Wo, Wo, Wo, Ww, Ww, Ww^Ewl, Gll^Fmf, Rb, Mm, Ww, Wwr, Gs^Vh, Hh, Gll^Fdf, Gll^Fdf, Hh, Gll^Fdf, Gll^Fmf, Mm, Mm, Ww^Ewf, Rb
Wo, Wo, Wo, Wo, Wwr, Ww, Hh, Rb, Rb, Mm, Ww, Gd, Mm, Gll^Fmf, Gd, Gll^Fmf, Gll^Fdf, Hh, Gll^Fdf, Gll^Fmf, Gll^Fmf, Rb
Wo, Wo, Wo, Ds, Mm, Gs, Gg^Efm, Gll^Fdf, Rb, Gs^Vh, Gg, Ww, Ww, Gll^Fmf, Ww, Ww, Ww, Gll^Fmf, Gd, Gll^Fdf, Hh, Mm
Wo, Wo, Mm, Ds, Gs, Gll^Fdf, Gg, Gll^Fmf, Gll^Fdf, Rb, Gll^Fdf, Gs, Ww, Ww, Mm, Gs^Vh, Re^Esd, Ww, Gg^Efm, Mm, Mm, Mm
Wo, Wo, Wo, Mm, Rb, Gg, Hh, Gs, Gg, Rb, Rb, Rb, Ww^Bw\, Mm, Mm, Mm, Ww, Ww, Rb, Rb, Rb^Esd, Mm
Wo, Wo, Wo, Wo, Ce, Ce, Ce, Gll^Fmf, Gll^Fdf, Rb, Gs, Wwr, Wwr, Rb, Rb, Gll^Fdf, Ww^Bw/, Rb, Mm, Mm, Mm, Rb
Wo, Wo, Wo, Mm, Sm, 3 Ke, Ce, Gll^Fdf, Gg^Gvs, Rb, Mm, Ww, Mm^Xm, Gs, Gg, Rb, Gll^Fmf, Ww, Mm, Hh^Vhh, Mm, Mm
Wo, Wo, Wo, Wo, Wo, Ss, Mm, Gs^Vh, Rb, Rb, Ww, Ww, Mm^Xm, Mm, Hh, Gg^Gvs, Gs^Vh, Ww, Wwr, Wo, Mm, Mm
Wo, Wo, Mm, Wo, Ww, Mm, Ww, Mm, Rb, Ch, Ww, Hh, Mm^Xm, Mm^Xm, Mm^Xm, Gll^Fmf, Gll^Fmf, Ww, Ww, Gll^Fmf, Gll^Fdf, Mm
Wo, Wo, Wo, Mm, Mm, Ww, Mm, Ww, Ww^Bw/, Rb^Esd, Ww, Mm, Mm^Xm, Mm^Xm, Mm^Xm, Mm, Gll^Fmf, Gg^Efm, Ww, Mm, Mm, Mm
Mm, Mm, Mm, Wo, Mm, Mm, Gll^Fmf, Re, Mm, Ww, Mm, Mm, Mm^Xm, Mm^Xm, Mm^Xm, Mm, Mm, Mm, Wo, Wo, Mm, Mm
Mm, Mm, Mm, Mm, Mm, Mm, Rb, Rb, Gg, Mm, Gg, Mm^Xm, Mm^Xm, Mm^Xm, Mm^Xm, Mm^Xm, Mm, Mm, Mm, Mm, Gg, Mm
