Mm, Mm, Mm, Mm, Mm, Gg, Mm, Mm, Mm, Mm, Mm, Mm, Mm, Ww, Ww, Mm, Mm, Mm, Mm, Mm, Mm, Mm, Mm, Mm, Mm, Mm, Mm, Gg, Mm, Mm, Mm, Mm
Mm, Mm, Mm, Mm, Mm, Mm, Mm, Mm, Mm, Mm, Rb^Ftr, Mm, Rb, Ww, Ww, Mm, Rb^Ftr, Hh^Vhh, Mm, Mm, Mm, Rb^Ftr, Gg, Mm, Mm, Mm, Mm, Rb^Ftr, Wot, Mm, Mm, Mm
Mm, Mm, Mm, Mm, Mm, Mm, Rb^Ftr, Hh^Vhh, Gg^Efm, Mm, Gg, Rb, Wot, Ww, Ww, Rb^Ftr, Gg, Gg^Efm, Rb, Rb^Ftr, Mm, Rb^Ftr, Sm, Gs, Mm, Mm, Mm, Ww, Hh^Vhh, Rb^Ftr, Mm, Mm
Mm, Mm, Mm, Mm, Rb^Ftr, Mm, Gg, Gs, Gg, Gd, Rb^Ftr, Rb, Wot, Ww, Wot, Ww, Ww, Rb^Ftr, Sm, Rb, Rb^Ftr, Rb^Ftr, Ww, Rb^Ftr, Mm, Mm, Ww, Ww, Mm, Mm, Mm, Mm
Rb, Rb, Rb, Mm, Ce, Rb^Ftr, Gd, Gg, Gg, Gg, Sm, Rp^Ftr, Wot, Wot, Rb^Es, Rb^Ftr, Chw, Ww, Wot, Ww, Ww, Ww, Wot, Wot, Mm, Mm, Ww, Mm, Mm, Mm, Mm, Mm
Mm, Rb, 1 Ke, 2 Ke, Ce, Gs, Gg, Gg, Rb^Ftr, Wot, Wot, Wot, Mm, Wot, Wot, Ww^Vhs, Ww^Bsb/, 4 Khw, Wot, Wot, Rb^Ftr, Mm, Wot, Wot, Wot, Mm, Ww, Mm, Rb^Ftr, Mm, Mm, Mm
Mm, Mm, Ce, Ce, Gg, Gs, Rb^Ftr, Gg, Rb, Wot, Wot, Wot, Wot, Wot, Ww^Ewl, Chw, Sm, Rp, Ww, Wot, Rb^Vhs, Mm, Rb, Wot, Wot, Wot, Wot, Sm, Mm, Mm, Mm, Mm
Mm, Rb^Ftr, Rb^Ftr, Gg, Gs, Gg, Wot, Rb^Ftr, Wwf^Es, Wwf^Es, Rb, Wot, Rb^Es, Wot, Wot, Ww, Wot, Wot, Ww, Wot, Wot, Rb^Ftr, Ww, Wot, Wot, Ww, Wot, Ww^Ewl, Rb^Ftr, Mm, Mm, Mm
Mm, Mm, Rb^Ftr, Gd, Gg, Ww, Wot, Wot, Ww, Wwf^Es, Re, Rb^Ftr, Rb^Ftr, Wot, Wot, Wot, Rb^Ftr, Wot, Wot, Wot, Ww, Ww, Rb^Ftr, Wot, Ww, Wot, Rb, Ww, Rb^Vhs, Mm, Rb^Ftr, Mm
Mm, Hh^Vhh, Gd, Gg, Ww, Ww, Rb^Ftr, Wot, Wot, Rb^Es, Rb^Es, Sm^Vhs, Wwf^Es, Ww^Es, Rb^Ftr, Ww^Ewl, Sm, Rb^Es, Wwf^Es, Rb^Es, Wwf^Es, Rb^Vhs, Chw, Rb^Ftr, Ww^Ewf, Rb^Ftr, Re, Wwf^Es, Wot, Rb^Ftr, Mm, Mm
Mm, Gg^Gvs, Gg, Gg, Rb^Ftr, Wot, Wot, Rb^Ftr, Wot, Wot, Ww, Ww^Ewl, Rb, Re, Sm, Re, Rb^Ftr, Rb^Ftr, Ww, Re, Ww, Gll^Ftr, Ww, Wwf^Es, Rb^Ftr, Sm, Rb^Es, Wot, Wot, Wot, Hh^Vhh, Mm
Mm, Mm, Gg^Efm, Gg, Rb, Wot, Wot, Rb^Vhs, Wot, Wot, Wot, Ww, Wwf^Es, Rb^Ftr, Wot, Rb^Es, Wwf^Es, Wwf^Es, Re, Ww, Wot, Wot, Wot, Re, Rb, Re, Gll^Ftr, Ww, Ww, Ww, Wot, Mm
Mm, Rb^Ftr, Gg, Gg, Rb^Ftr, Wot, Ww, Ww, Ww, Ww, Ww, Khw, Chw, Ww, Wot, Wot, Rb^Ftr, Rb^Ftr, Sm, Rb, Rb^Ftr, Wot, Ww, Sm, Cte^Es, Cte^Es, Rb^Vd, Mm, Wot, Wot, Mm, Mm
Mm, Mm, Mm, Gd, Gg, Rb^Ftr, Re, Rb^Es, Rb^Es, Rb^Ftr, Re, Ww^Bw/r, Wot, Rp^Vhs, Ww, Ww, Rb^Es, Ww^Ewl, Ww^Vhs, Rb^Ftr, Rb^Es, Sm, Rb^Ftr, Wwf, Cte^Es, 3 Kte, Rb, Ww, Ww, Mm, Mm, Mm
Mm, Mm, Rb^Ftr, Gg, Rb^Ftr, Rb, Re, Rb^Ftr, Re, Rb, Rb^Ftr, Wot, Wot, Ww, Rb, Wwf^Es, Ww, Ww, Rb^Ftr, Rb^Ftr, Ww, Re, Ww, Sm, Wwf^Es, Cte^Es, Ww^Ewl, Ww^Bw\r, Re, Rb, Re, Mm
Mm, Mm, Rb^Ftr, Gg^Efm, Gg, Rb, Gg, Rb^Ftr, Gg, Rb, Re, Rb^Ftr, Ww, Rb^Ftr, Sm, Ww, Rb^Ftr, Wot, Wot, Ww, Rb^Ftr, Ww, Rb^Ftr, Rb^Ftr, Rb, Wwf^Es, Ww, Ww, Mm, Rb^Es, Rb^Es, Rb^Es
Mm, Mm, Mm, Mm, Hh^Vhh, Gg, Mm, Gs, Gd, Gs, Ww, Ww^Bw\r, Rb, Rb^Es, Rb, Rb^Ftr, Rb^Ftr, Chw, Wot, Wot, Ww, Ww, Rr^Vd, Rb^Es, Re, Sm, Rb^Ftr, Rb^Ftr, Rb^Ftr, Mm, Mm, Rb
Mm, Mm, Mm, Mm, Mm, Rb^Ftr, Mm, Rb^Ftr, Gg, Gg, Ww, Gg, Gs, Re, Gs, Re, Rb, Sm, Re, Rb^Ftr, Ww^Ftr, Sm, Rb^Ftr, Rb^Ftr, Re, Rb, Gs, Rb, Mm, Mm, Mm, Mm
Mm, Mm, Mm, Mm, Mm, Mm, Mm, Mm, Ww, Ww, Ww, Rb^Ftr, Gg^Gvs, Gg, Rb^Ftr, Rb, Re, Rb, Rb, Rb, Gg, Rb^Es, Gg, Rb, Gs, Mm, Mm, Gg^Efm, Mm, Mm, Mm, Mm
Mm, Mm, Mm, Mm, Mm, Mm, Rb^Ftr, Re, Ww, Mm, Ww, Gll^Ftr, Mm, Gs^Vh, Mm, Mm, Mm, Rb^Ftr, Gg, Gs, Rb^Ftr, Gs, Gd, Gg, Gll^Ftr, Mm, Mm, Mm, Mm, Mm, Mm, Mm
Gg, Mm, Mm, Mm, Mm, Mm, Mm, Rb^Ftr, Ww, Mm, Mm, Ww, Rb^Ftr, Mm, Mm, Mm, Mm, Rb^Ftr, Mm, Gg^Efm, Gll^Ftr, Mm, Mm, Mm, Mm, Mm, Mm, Mm, Mm, Mm, Mm, Mm
Gg, Mm, Gg, Mm, Gg, Mm, Gg, Ww, Mm, Mm, Mm, Ww, Gg, Mm, Mm, Wot, Mm, Mm, Mm, Mm, Mm, Mm, Gg, Mm, Mm, Mm, Mm, Mm, Mm, Mm, Mm, Mm
