Mm, Mm, Mm, Mm, Mm, Mm, Mm, Mm, Mm, Mm, Mm, Mm, Mm, Mm, Mm, Mm, Mm, Mm, Mm, Mm, Mm, Mm, Mm, Mm, Mm, Mm, Mm, Mm, Mm, Mm
Mm, Mm, Gs^Fms, Gs^Fds, Gs^Fms, Mm, Mm, Mm, Mm, Mm, Mm, Mm, Mm, Mm, Gs^Fms, Gs^Fms, Mm, Mm, Mm, Mm, Ce, 3 Ke, Ce, Mm, Mm, Mm, Mm, Mm, Mm, Mm
Mm, Gs^Fms, 4 Ket, Ql, Mm, Mm, Mm, Mm, Gs^Fms, Mm, Mm, Mm, Mm, Gs^Fms, Gs^Es, Mm, Mm, Mm, Mm, Rd^Es, Rb^Es, Rb^Es, Re^Es, Mm, Mm, Mm, Mm, Mm, Mm, Mm
Mm, Ce, Ce, Ce, Mm, Mm, Gs^Fms, Gs, Gs^Fms, Mm, Gs^Fms, Gs, Gs, Gs^Es, Chr, Gs^Fms, Mm, Mm, Gs^Fms, Re^Es, Rb^Es, Rb^Es, Gs^Fms, Mm, Mm, Mm, Mm, Mm, Mm, Mm
Mm, Rd^Es, Rb^Es, Rb^Es, Gs^Fds, Mm, Gs^Fms, Gs, Gd, Gd, Gs, Gs, Gg, Gs, Gs, Gs^Fds, Gs^Fms, Mm, Gs^Fds, Rb, Gll, Gll^Es, Chr, Mm, Gs^Fds, Mm, Mm, Mm, Mm, Mm
Mm, Mm, Mm, Rb^Es, Rd^Es, Gs^Fms, Gll^Es, Gs^Fds, Gs^Fms, Gd, Gs^Es, Mm, Mm, Gs^Fms, Gs^Fms, Gg, Ww, Ww, Ww, Gs^Fms, Rp, Rp, Rp, Gs^Fms, Rp, Mm, Mm, Wo, Wo, Mm
Mm, Mm, Mm, Mm, Chr, Gll^Es, Gll, Gll, Gs, Gs, Gs^Fds, Mm, Mm, Ww^Ewf, Ww, Rb, Ww, Gs^Fms, Rp, Ww^Bw/, Gg, Gs^Es, Gs, Rp, Gg, Chr, Wo, Wo, Wo, Wo
Gs^Fds, Mm, Gs^Fms, Gs^Fms, Ww, Ww, Ww^Bw/, Rp, Rp, Gs^Fms, Rp, Gs^Fms, Wwf, Ww, Mm, Ww, Rp, Rp, Ww, Ww, Gg, Gs^Fms, Gd, Gg, Ww^Ewl, Ww^Bsb|, Wo, Wo, Wo, Wo
Ww, Gs^Fds, Ww^Ewl, Gs^Fms, Ww, Rp, Gg, Ww, Gs^Fms, Rp, Gg^Es, Rp, Ww^Bw\, Gg, Rp, Mm, Rp, Chr, Gs^Fms, Ww, Mm, Mm, Gs^Fms, Gg, Ww, Chr, Rp, Wo, Rp, Wo
Rp, Ww, Ww, Ww, Rp, Rp, Gg, Ww, Gs^Fds, Chr, Mm, Ww, Ww, Rp, Gs^Es, Rp, Gs, Gs, Gg, Wwf, Wwf, Gs^Fds, Gs^Fds, Gs^Fms, Ww, Gg, Mm, Rp, Mm, Rp
Mm, Rp, Rp, Rp, Gs^Fms, Gs^Fms, Gg, Ww, Wwf, Gs^Fms, Ww, Ww, Gs^Fms, Gg, Gs, Gd, Gd, Gs^Es, Gg, Gg, Ww, Rb, Gs^Fms, Ww, Gs^Fms, Gg, Gs^Fds, Mm, Mm, Mm
Mm, Gs^Fms, Gs^Fds, Gs^Fds, Gs^Fms, Gs^Fms, Gs, Gg, Gg^Es, Wwf, Gg, Gg, Gs^Fms, Gs^Fds, Gs, Gs, Gs^Fds, Gs^Fms, Gg, Ww^Ewl, Ww, Chr, Ww, Wwf, Gg, Gs, Re^Vct, Mm, Mm, Mm
Mm, Mm, Mm, Mm, Mm, Mm, Re^Vct, Gd, Gd, Gg, Gs, Gs, Gd^Es, Gs^Es, Mm, Mm, Mm, Gs^Fms, Gs, Gg^Es, Gs^Fms, Ww, Gs^Fms, Gg, Gs, Gs, 1 Ke, Mm, Mm, Mm
Mm, Mm, Mm, Mm, Mm, Mm, Mm, Gs^Es, Mm, Gs, Gd, Gs, Gs, Mm, Mm, Mm, Mm, Mm, Gs, Gs, Gs^Fms, Gs^Fds, Gs, Gs, Gs, 2 Ke, Ce, Ce, Mm, Mm
Mm, Mm, Mm, Mm, Mm, Mm, Mm, Mm, Re^Vct, Gs^Fms, Gd^Es, Gs, Gs, Gs^Fms, Gs^Fds, Gs^Fms, Mm, Mm, Ww^Ewf, Gs, Gd, Gs^Es, Gs, Gs, Gs^Fds, Ce, Mm, Mm, Mm, Mm
Mm, Mm, Mm, Mm, Mm, Mm, Mm, Mm, Mm, Mm, Re^Vct, Gs, Gs^Es, Gs^Fms, Mm, Mm, Mm, Re^Vct, Mm, Gd^Es, Gs^Fms, Gd, Re^Vct, Gs^Fms, Gs^Fms, Re^Vct, Mm, Mm, Mm, Mm
Mm, Mm, Mm, Mm, Gd, Mm, Gd, Mm, Mm, Mm, Gs^Fms, Gs^Fds, Gs^Fms, Mm, Gs^Fms, Mm, Mm, Mm, Mm, Gs^Fms, Gs^Fds, Gs^Fms, Mm, Mm, Mm, Gs^Fds, Gs^Fms, Mm, Mm, Mm
