Mm, Mm, Mm, Mm, Mm, Mm, Mm, Mm, Mm, Mm, Mm, Mm, Mm, Mm, Mm, Mm, Mm, Mm, Mm, Mm, Mm, Mm, Mm, Mm, Mm, Mm, Mm, Mm, Mm, Mm
Mm, Mm, Gs^Fms, Gs^Fds, Gs^Fms, Mm, Mm, Mm, Mm, Mm, Mm, Mm, Mm, Mm, Gs^Fms, Gs^Vhr, Mm, Mm, Mm, Mm, Ce, 3 Ke, Ce, Mm, Mm, Mm, Mm, Mm, Mm, Mm
Mm, Ce, 4 Ket, Mm, Mm, Mm, Mm, Mm, Gs^Fms, Mm, Mm, Mm, Mm, Gs^Fms, Gs^Es, Mm, Mm, Mm, Mm, Rd^Es, Rb^Es, Ce, Re^Es, Mm, Mm, Mm, Mm, Mm, Mm, Mm
Mm, Ce, Ce, Ce, Mm, Mm, Gs^Fms, Gs^Vhr, Gs^Fms, Mm, Gs^Fms, Rd, Gs, Gs^Es, Chr, Gs^Fms, Mm, Mm, Gs^Fms, Re^Es, Rb^Es, Rb^Es, Gs^Vhr, Mm, Mm, Mm, Mm, Mm, Mm, Mm
Mm, Rd^Es, Rb^Es, Rb^Es, Gs^Fds, Mm, Gs^Fms, Gs, Gd, Gd, Gs, Gs, Gg, Gs, Gs^Efm, Gs^Fds, Gs^Fms, Mm, Gs^Fds, Rb, Gll, Gll^Es, Chr, Mm, Gs^Fds, Mm, Mm, Mm, Mm, Mm
Mm, Mm, Mm, Rb^Es, Rd^Es, Gs^Fms, Gll^Es, Gs^Fds, Gs^Fms, Gd, Gs^Es, Mm, Mm, Gs^Fms, Gs^Fms, Gg, Ww, Ww, Wwf^Es, Gs^Fms, Rp, Rp, Rp, Gs^Fms, Rp, Mm, Mm, Wo, Wo, Mm
Mm, Mm, Mm, Mm, Chr, Gll^Es, Gll, Gll, Gs, Gs, Gs^Fds, Mm, Mm, Ww^Ewf, Ww, Rb, Wwf^Es, Gs^Vhr, Rp, Ww^Bw/, Gg, Gs^Es, Gs, Rp, Gg, Chr, Wo, Wo, Wo, Wo
Gs^Fds, Mm, Gs^Fms, Gs^Fms, Wwf^Es, Wwf^Es, Ww^Bw/, Rp, Rp, Gs^Fms, Rp, Gs^Fms, Wwf^Es, Ww, Mm, Wwf^Es, Rp, Rp, Ww, Ww, Gg, Gs^Fms, Gd, Gg^Efm, Ww^Ewl, Ww^Bsb|, Wo, Wo, Wo, Wo
Ww, Gs^Fds, Ww^Ewl, Gs^Fms, Ww, Rp, Gg, Wwf^Es, Gs^Vhr, Rp, Gs, Rp, Ww^Bw\, Gs^Vhr, Rp, Mm, Rp, Chr, Gs^Fms, Ww, Mm, Mm, Gs^Fms, Gg, Ww, Chr, Mm, Wo, Wo, Wo
Rp, Ww, Ww, Ww, Rp, Rp, Gg, Ww, Gs^Fds, Chr, Mm, Ww, Ww, Rp, Gs^Es, Rp, Gs, Gs, Gs, Wwf^Es, Wwf^Es, Gs^Vhr, Gs^Fds, Gs^Fms, Ww, Rp, Mm, Ds, Mm, Rp
Mm, Rp, Rp, Rp, Gs^Fms, Gs^Fms, Gg, Ww, Wwf^Es, Gs^Fms, Wwf^Es, Ww, Gs^Fms, Gg, Gs, Gd, Gs^Vhr, Gs^Es, Gs, Gg, Ww, Rb, Gs^Fms, Ww, Gs^Fms, Rp, Gs^Fds, Mm, Mm, Mm
Mm, Gs^Fms, Gs^Fds, Gs^Fds, Gs^Fms, Gs^Fms, Gs^Efm, Gg, Gg^Es, Wwf^Es, Gg, Gg, Gs^Fms, Gs^Fds, Gs, Gg^Gvs, Gg^Gvs, Gs^Fms, Gg, Ww^Ewl, Ww, Chr, Wwf^Es, Wwf^Es, Gg, Rp, Re^Vct, Mm, Mm, Mm
Mm, Mm, Mm, Mm, Mm, Mm, Gs^Vhr, Gd, Gd, Gg, Gs, Gs, Gd^Es, Gs^Es, Mm, Mm, Mm, Gs^Fms, Gs, Gg^Es, Gs^Fms, Ww, Gs^Fms, Gg, Rp, Rp, 1 Ke, Mm, Mm, Mm
Mm, Mm, Mm, Mm, Mm, Mm, Mm, Gs^Es, Mm, Gs, Gd, Gs, Gs, Mm, Mm, Mm, Mm, Mm, Gd^Es, Gs, Gs^Fms, Gs^Fds, Gs, Gs, Rp, Ce, Ce, Ce, Mm, Mm
Mm, Mm, Mm, Mm, Mm, Mm, Mm, Mm, Gs^Fds, Gs^Fms, Gd^Es, Gs, Gs, Gs^Fms, Gs^Fds, Gs^Fms, Mm, Mm, Ww^Ewf, Gs, Gd, Gs^Es, Gs, Gs, 2 Ke, Rp, Rp, Mm, Mm, Mm
Mm, Mm, Mm, Mm, Mm, Mm, Mm, Mm, Mm, Ww, Gs^Vhr, Gs, Gs^Es, Gs^Fms, Mm, Mm, Mm, Mm, Mm, Gs^Vhr, Gs^Fms, Gd, Re^Vct, Ce, Ce, Ce, Rp, Mm, Mm, Mm
Mm, Mm, Mm, Mm, Gd, Mm, Gd, Mm, Mm, Mm, Gs^Fms, Gs^Fds, Gs^Fms, Mm, Gs^Fms, Mm, Mm, Mm, Mm, Gs^Fms, Gs^Fds, Gs^Fms, Mm, Mm, Mm, Gs^Fds, Gs^Fms, Rp, Mm, Mm
